#
# Generate map in an (imaginary) Kiva setting.
#
# The map is 81 * 101, with 80 operation positions, 320 shelf operation point, 80 temporary
# storage point, 160 shelf groups(20 * 8), 3200 shelf spaces, 152 rest areas.
# '.' : empty.
# 'O' : operation position.
# 'P' : shelf operation point.
# 'T' : temporary storage point.
# 'S' : shelf storage point.
# 'B' : blocked area.
# 'R' : rest area.
#
# X_LIMIT
# Y_LIMIT
# Robot count
# Shelf count
# Map
81
101
10
200
.....................................................................................................
.PP.PP.SSSSSSSSSS.SSSSSSSSSS.SSSSSSSSSS.SSSSSSSSSS.SSSSSSSSSS.SSSSSSSSSS.SSSSSSSSSS.SSSSSSSSSS.PP.PP.
.OP.OP.BBBBBBBBBB.BBBBBBBBBB.BBBBBBBBBB.BBBBBBBBBB.BBBBBBBBBB.BBBBBBBBBB.BBBBBBBBBB.BBBBBBBBBB.PO.PO.
.TP.TP.SSSSSSSSSS.SSSSSSSSSS.SSSSSSSSSS.SSSSSSSSSS.SSSSSSSSSS.SSSSSSSSSS.SSSSSSSSSS.SSSSSSSSSS.PT.PT.
.RR.RR.........................................................................................RR.RR.
.PP.PP.SSSSSSSSSS.SSSSSSSSSS.SSSSSSSSSS.SSSSSSSSSS.SSSSSSSSSS.SSSSSSSSSS.SSSSSSSSSS.SSSSSSSSSS.PP.PP.
.OP.OP.BBBBBBBBBB.BBBBBBBBBB.BBBBBBBBBB.BBBBBBBBBB.BBBBBBBBBB.BBBBBBBBBB.BBBBBBBBBB.BBBBBBBBBB.PO.PO.
.TP.TP.SSSSSSSSSS.SSSSSSSSSS.SSSSSSSSSS.SSSSSSSSSS.SSSSSSSSSS.SSSSSSSSSS.SSSSSSSSSS.SSSSSSSSSS.PT.PT.
.RR.RR.........................................................................................RR.RR.
.PP.PP.SSSSSSSSSS.SSSSSSSSSS.SSSSSSSSSS.SSSSSSSSSS.SSSSSSSSSS.SSSSSSSSSS.SSSSSSSSSS.SSSSSSSSSS.PP.PP.
.OP.OP.BBBBBBBBBB.BBBBBBBBBB.BBBBBBBBBB.BBBBBBBBBB.BBBBBBBBBB.BBBBBBBBBB.BBBBBBBBBB.BBBBBBBBBB.PO.PO.
.TP.TP.SSSSSSSSSS.SSSSSSSSSS.SSSSSSSSSS.SSSSSSSSSS.SSSSSSSSSS.SSSSSSSSSS.SSSSSSSSSS.SSSSSSSSSS.PT.PT.
.RR.RR.........................................................................................RR.RR.
.PP.PP.SSSSSSSSSS.SSSSSSSSSS.SSSSSSSSSS.SSSSSSSSSS.SSSSSSSSSS.SSSSSSSSSS.SSSSSSSSSS.SSSSSSSSSS.PP.PP.
.OP.OP.BBBBBBBBBB.BBBBBBBBBB.BBBBBBBBBB.BBBBBBBBBB.BBBBBBBBBB.BBBBBBBBBB.BBBBBBBBBB.BBBBBBBBBB.PO.PO.
.TP.TP.SSSSSSSSSS.SSSSSSSSSS.SSSSSSSSSS.SSSSSSSSSS.SSSSSSSSSS.SSSSSSSSSS.SSSSSSSSSS.SSSSSSSSSS.PT.PT.
.RR.RR.........................................................................................RR.RR.
.PP.PP.SSSSSSSSSS.SSSSSSSSSS.SSSSSSSSSS.SSSSSSSSSS.SSSSSSSSSS.SSSSSSSSSS.SSSSSSSSSS.SSSSSSSSSS.PP.PP.
.OP.OP.BBBBBBBBBB.BBBBBBBBBB.BBBBBBBBBB.BBBBBBBBBB.BBBBBBBBBB.BBBBBBBBBB.BBBBBBBBBB.BBBBBBBBBB.PO.PO.
.TP.TP.SSSSSSSSSS.SSSSSSSSSS.SSSSSSSSSS.SSSSSSSSSS.SSSSSSSSSS.SSSSSSSSSS.SSSSSSSSSS.SSSSSSSSSS.PT.PT.
.RR.RR.........................................................................................RR.RR.
.PP.PP.SSSSSSSSSS.SSSSSSSSSS.SSSSSSSSSS.SSSSSSSSSS.SSSSSSSSSS.SSSSSSSSSS.SSSSSSSSSS.SSSSSSSSSS.PP.PP.
.OP.OP.BBBBBBBBBB.BBBBBBBBBB.BBBBBBBBBB.BBBBBBBBBB.BBBBBBBBBB.BBBBBBBBBB.BBBBBBBBBB.BBBBBBBBBB.PO.PO.
.TP.TP.SSSSSSSSSS.SSSSSSSSSS.SSSSSSSSSS.SSSSSSSSSS.SSSSSSSSSS.SSSSSSSSSS.SSSSSSSSSS.SSSSSSSSSS.PT.PT.
.RR.RR.........................................................................................RR.RR.
.PP.PP.SSSSSSSSSS.SSSSSSSSSS.SSSSSSSSSS.SSSSSSSSSS.SSSSSSSSSS.SSSSSSSSSS.SSSSSSSSSS.SSSSSSSSSS.PP.PP.
.OP.OP.BBBBBBBBBB.BBBBBBBBBB.BBBBBBBBBB.BBBBBBBBBB.BBBBBBBBBB.BBBBBBBBBB.BBBBBBBBBB.BBBBBBBBBB.PO.PO.
.TP.TP.SSSSSSSSSS.SSSSSSSSSS.SSSSSSSSSS.SSSSSSSSSS.SSSSSSSSSS.SSSSSSSSSS.SSSSSSSSSS.SSSSSSSSSS.PT.PT.
.RR.RR.........................................................................................RR.RR.
.PP.PP.SSSSSSSSSS.SSSSSSSSSS.SSSSSSSSSS.SSSSSSSSSS.SSSSSSSSSS.SSSSSSSSSS.SSSSSSSSSS.SSSSSSSSSS.PP.PP.
.OP.OP.BBBBBBBBBB.BBBBBBBBBB.BBBBBBBBBB.BBBBBBBBBB.BBBBBBBBBB.BBBBBBBBBB.BBBBBBBBBB.BBBBBBBBBB.PO.PO.
.TP.TP.SSSSSSSSSS.SSSSSSSSSS.SSSSSSSSSS.SSSSSSSSSS.SSSSSSSSSS.SSSSSSSSSS.SSSSSSSSSS.SSSSSSSSSS.PT.PT.
.RR.RR.........................................................................................RR.RR.
.PP.PP.SSSSSSSSSS.SSSSSSSSSS.SSSSSSSSSS.SSSSSSSSSS.SSSSSSSSSS.SSSSSSSSSS.SSSSSSSSSS.SSSSSSSSSS.PP.PP.
.OP.OP.BBBBBBBBBB.BBBBBBBBBB.BBBBBBBBBB.BBBBBBBBBB.BBBBBBBBBB.BBBBBBBBBB.BBBBBBBBBB.BBBBBBBBBB.PO.PO.
.TP.TP.SSSSSSSSSS.SSSSSSSSSS.SSSSSSSSSS.SSSSSSSSSS.SSSSSSSSSS.SSSSSSSSSS.SSSSSSSSSS.SSSSSSSSSS.PT.PT.
.RR.RR.........................................................................................RR.RR.
.PP.PP.SSSSSSSSSS.SSSSSSSSSS.SSSSSSSSSS.SSSSSSSSSS.SSSSSSSSSS.SSSSSSSSSS.SSSSSSSSSS.SSSSSSSSSS.PP.PP.
.OP.OP.BBBBBBBBBB.BBBBBBBBBB.BBBBBBBBBB.BBBBBBBBBB.BBBBBBBBBB.BBBBBBBBBB.BBBBBBBBBB.BBBBBBBBBB.PO.PO.
.TP.TP.SSSSSSSSSS.SSSSSSSSSS.SSSSSSSSSS.SSSSSSSSSS.SSSSSSSSSS.SSSSSSSSSS.SSSSSSSSSS.SSSSSSSSSS.PT.PT.
.RR.RR.........................................................................................RR.RR.
.PP.PP.SSSSSSSSSS.SSSSSSSSSS.SSSSSSSSSS.SSSSSSSSSS.SSSSSSSSSS.SSSSSSSSSS.SSSSSSSSSS.SSSSSSSSSS.PP.PP.
.OP.OP.BBBBBBBBBB.BBBBBBBBBB.BBBBBBBBBB.BBBBBBBBBB.BBBBBBBBBB.BBBBBBBBBB.BBBBBBBBBB.BBBBBBBBBB.PO.PO.
.TP.TP.SSSSSSSSSS.SSSSSSSSSS.SSSSSSSSSS.SSSSSSSSSS.SSSSSSSSSS.SSSSSSSSSS.SSSSSSSSSS.SSSSSSSSSS.PT.PT.
.RR.RR.........................................................................................RR.RR.
.PP.PP.SSSSSSSSSS.SSSSSSSSSS.SSSSSSSSSS.SSSSSSSSSS.SSSSSSSSSS.SSSSSSSSSS.SSSSSSSSSS.SSSSSSSSSS.PP.PP.
.OP.OP.BBBBBBBBBB.BBBBBBBBBB.BBBBBBBBBB.BBBBBBBBBB.BBBBBBBBBB.BBBBBBBBBB.BBBBBBBBBB.BBBBBBBBBB.PO.PO.
.TP.TP.SSSSSSSSSS.SSSSSSSSSS.SSSSSSSSSS.SSSSSSSSSS.SSSSSSSSSS.SSSSSSSSSS.SSSSSSSSSS.SSSSSSSSSS.PT.PT.
.RR.RR.........................................................................................RR.RR.
.PP.PP.SSSSSSSSSS.SSSSSSSSSS.SSSSSSSSSS.SSSSSSSSSS.SSSSSSSSSS.SSSSSSSSSS.SSSSSSSSSS.SSSSSSSSSS.PP.PP.
.OP.OP.BBBBBBBBBB.BBBBBBBBBB.BBBBBBBBBB.BBBBBBBBBB.BBBBBBBBBB.BBBBBBBBBB.BBBBBBBBBB.BBBBBBBBBB.PO.PO.
.TP.TP.SSSSSSSSSS.SSSSSSSSSS.SSSSSSSSSS.SSSSSSSSSS.SSSSSSSSSS.SSSSSSSSSS.SSSSSSSSSS.SSSSSSSSSS.PT.PT.
.RR.RR.........................................................................................RR.RR.
.PP.PP.SSSSSSSSSS.SSSSSSSSSS.SSSSSSSSSS.SSSSSSSSSS.SSSSSSSSSS.SSSSSSSSSS.SSSSSSSSSS.SSSSSSSSSS.PP.PP.
.OP.OP.BBBBBBBBBB.BBBBBBBBBB.BBBBBBBBBB.BBBBBBBBBB.BBBBBBBBBB.BBBBBBBBBB.BBBBBBBBBB.BBBBBBBBBB.PO.PO.
.TP.TP.SSSSSSSSSS.SSSSSSSSSS.SSSSSSSSSS.SSSSSSSSSS.SSSSSSSSSS.SSSSSSSSSS.SSSSSSSSSS.SSSSSSSSSS.PT.PT.
.RR.RR.........................................................................................RR.RR.
.PP.PP.SSSSSSSSSS.SSSSSSSSSS.SSSSSSSSSS.SSSSSSSSSS.SSSSSSSSSS.SSSSSSSSSS.SSSSSSSSSS.SSSSSSSSSS.PP.PP.
.OP.OP.BBBBBBBBBB.BBBBBBBBBB.BBBBBBBBBB.BBBBBBBBBB.BBBBBBBBBB.BBBBBBBBBB.BBBBBBBBBB.BBBBBBBBBB.PO.PO.
.TP.TP.SSSSSSSSSS.SSSSSSSSSS.SSSSSSSSSS.SSSSSSSSSS.SSSSSSSSSS.SSSSSSSSSS.SSSSSSSSSS.SSSSSSSSSS.PT.PT.
.RR.RR.........................................................................................RR.RR.
.PP.PP.SSSSSSSSSS.SSSSSSSSSS.SSSSSSSSSS.SSSSSSSSSS.SSSSSSSSSS.SSSSSSSSSS.SSSSSSSSSS.SSSSSSSSSS.PP.PP.
.OP.OP.BBBBBBBBBB.BBBBBBBBBB.BBBBBBBBBB.BBBBBBBBBB.BBBBBBBBBB.BBBBBBBBBB.BBBBBBBBBB.BBBBBBBBBB.PO.PO.
.TP.TP.SSSSSSSSSS.SSSSSSSSSS.SSSSSSSSSS.SSSSSSSSSS.SSSSSSSSSS.SSSSSSSSSS.SSSSSSSSSS.SSSSSSSSSS.PT.PT.
.RR.RR.........................................................................................RR.RR.
.PP.PP.SSSSSSSSSS.SSSSSSSSSS.SSSSSSSSSS.SSSSSSSSSS.SSSSSSSSSS.SSSSSSSSSS.SSSSSSSSSS.SSSSSSSSSS.PP.PP.
.OP.OP.BBBBBBBBBB.BBBBBBBBBB.BBBBBBBBBB.BBBBBBBBBB.BBBBBBBBBB.BBBBBBBBBB.BBBBBBBBBB.BBBBBBBBBB.PO.PO.
.TP.TP.SSSSSSSSSS.SSSSSSSSSS.SSSSSSSSSS.SSSSSSSSSS.SSSSSSSSSS.SSSSSSSSSS.SSSSSSSSSS.SSSSSSSSSS.PT.PT.
.RR.RR.........................................................................................RR.RR.
.PP.PP.SSSSSSSSSS.SSSSSSSSSS.SSSSSSSSSS.SSSSSSSSSS.SSSSSSSSSS.SSSSSSSSSS.SSSSSSSSSS.SSSSSSSSSS.PP.PP.
.OP.OP.BBBBBBBBBB.BBBBBBBBBB.BBBBBBBBBB.BBBBBBBBBB.BBBBBBBBBB.BBBBBBBBBB.BBBBBBBBBB.BBBBBBBBBB.PO.PO.
.TP.TP.SSSSSSSSSS.SSSSSSSSSS.SSSSSSSSSS.SSSSSSSSSS.SSSSSSSSSS.SSSSSSSSSS.SSSSSSSSSS.SSSSSSSSSS.PT.PT.
.RR.RR.........................................................................................RR.RR.
.PP.PP.SSSSSSSSSS.SSSSSSSSSS.SSSSSSSSSS.SSSSSSSSSS.SSSSSSSSSS.SSSSSSSSSS.SSSSSSSSSS.SSSSSSSSSS.PP.PP.
.OP.OP.BBBBBBBBBB.BBBBBBBBBB.BBBBBBBBBB.BBBBBBBBBB.BBBBBBBBBB.BBBBBBBBBB.BBBBBBBBBB.BBBBBBBBBB.PO.PO.
.TP.TP.SSSSSSSSSS.SSSSSSSSSS.SSSSSSSSSS.SSSSSSSSSS.SSSSSSSSSS.SSSSSSSSSS.SSSSSSSSSS.SSSSSSSSSS.PT.PT.
.RR.RR.........................................................................................RR.RR.
.PP.PP.SSSSSSSSSS.SSSSSSSSSS.SSSSSSSSSS.SSSSSSSSSS.SSSSSSSSSS.SSSSSSSSSS.SSSSSSSSSS.SSSSSSSSSS.PP.PP.
.OP.OP.BBBBBBBBBB.BBBBBBBBBB.BBBBBBBBBB.BBBBBBBBBB.BBBBBBBBBB.BBBBBBBBBB.BBBBBBBBBB.BBBBBBBBBB.PO.PO.
.TP.TP.SSSSSSSSSS.SSSSSSSSSS.SSSSSSSSSS.SSSSSSSSSS.SSSSSSSSSS.SSSSSSSSSS.SSSSSSSSSS.SSSSSSSSSS.PT.PT.
.....................................................................................................